0000031000000000
0030000300310030
0330333300311300
0001100003313000
0330333330000000
0031300003303330
0031303300303000
0330303000000300
0000031103030331
0003034133030301
3333033300031300
0103000033331300
0013333000001100
0030030033330330
0300030030300300
0000000000300000