3
16
16

1111111111111111
1111111111111111
1111111111111111
1111111111111111
1111111111111111
1111111111111111
1111111111111111
1111111111111111
1111111111111111
1111111111111111
1111111111111111
1111111111111111
1111111111111111
1111111111111111
1111111111111111
1111111111111111

0000000020004500
0444044400404442
0402000400400000
0404440404442400
0004000000000400
4404044424440044
0400040000040004
0404040444040404
0204000400000400
4044040404440444
4000040004200000
4404044004044424
0004220000040004
2444040400040404
0000040444200400
0044440000044400

9000000000000009
0000000000000000
0090000000090000
0000000000000000
0000000000000000
0000000000000000
0000009000000000
0000000000000000
0000000090000090
0000000000000000
0000000000000000
0000000000000000
0090000000000000
0000000000000000
0000000000000000
0800009000000000
