3
16
16

1111111111111111
1111111111111111
1111111111111111
1111111111111111
1111111111111111
1111111111111111
1111111111111111
1111111111111111
1111111111111111
1111111111111111
1111111111111111
1111111111111111
1111111111111111
1111111111111111
1111111111111111
1111111111111111

0000042000000000
0040000400420040
0440444400422400
0002200004424000
0440444440000000
0042400004404440
0042404400404000
0440404000000400
0000042204040442
0004045244040402
4444044400042400
0204000044442400
0024444000002200
0040040044440440
0400040040400400
0000000000400000

0009000000000000
0000000000000009
0000000000000000
0000000090000000
0000000000000000
0000000090000000
0900000000000000
0000000000000000
0000000000000000
0000000000009000
0000000000900090
0080000000000000
0000000000000000
0000000000000000
0000000900000000
0000000000000000

