0003030030303000
0300000030000030
0113130000303110
0303031333313030
0303030030303030
0303000030003030
0301030030301030
0003033111303000
1103030143303000
0301030311301030
0303000300003030
0303030300303030
0303033330303030
0103030100303110
0301000300100030
0003030300303000