3
16
16

1111111111111111
1111111111111111
1111111111111111
1111111111111111
1111111111111111
1111111111111111
1111111111111111
1111111111111111
1111111111111111
1111111111111111
1111111111111111
1111111111111111
1111111111111111
1111111111111111
1111111111111111
1111111111111111

0000040000000405
4000040444044400
4044440040020004
0000000040044404
2244424020004020
4040004044404040
4040004000000040
4000404442442444
4244400002240400
0000444444000000
0004000000044400
0400400400040000
0400000424442444
2444244400040040
0004004000440040
4000000000000000

9000009000900090
0000000000000000
0000000000000000
0000000000000000
0000000000000000
0000090000000000
0000000000000900
0000000000000000
0000000000000009
9000000000900000
0000000000000000
0000000000000000
0000000000000000
0000000000000009
0000000000000000
0800000000000000