2
16
16

1111111111111111
1111111111111111
1111111111111111
1111111111111111
1111111111111111
1111111111111111
1111111111111111
1111111111111111
1111111111111111
1111111111111111
1111111111111111
1111111111111111
1111111111111111
1111111111111111
1111111111111111
1111111111111111

0004040040404000
0400000040000040
0224240000404220
0404042444424040
0404040040404040
0404000040004040
0402040040402040
0004044222404000
2204040254404000
0402040422402040
0404000400004040
0404040400404040
0404044440404040
0204040200404220
0402000400200040
0004040400404000

0000000000000000
0000000000000000
0000000000000000
0000000000000000
0000100000000000
1000000000010000
0000001000000000
0000000000000000
0000000000000001
0000000000000000
0000000000000000
0000000000010000
0000000001000000
0000000000000000
0000001000000000