3
16
16

1111111111111111
1111111111111111
1111111111111111
1111111111111111
1111111111111111
1111111111111111
1111111111111111
1111111111111111
1111111111111111
1111111111111111
1111111111111111
1111111111111111
1111111111111111
1111111111111111
1111111111111111
1111111111111111

4000040004404054
4400044000420044
0220040400022440
0044000000404400
4004422442244200
0000024444000200
4000044024400444
4420440020440200
0224400420044200
0244004040004400
0440002044440440
0000442000020000
2440040404420440
0044000404004400
0404400400044000
0000440220440004

0000900090000000
0000000000009000
9000000000000000
0000000000000000
0000000000000000
0000000000000090
0000000000000000
0000000000000009
9000090000000000
0000000900090000
0000000000000000
0000000000000000
0000000000000000
0000000000000000
0000000000000000
0008009000000000