0000000030003111
0333333030313430
0000001130303330
3333313030300000
0000013031333333
0333313030010000
0300013033313330
0303003000000000
0003003333333333
3333000000300000
0003333330303330
0000301030303030
1331303030303030
0030303030003000
0030303031333011
0030003000000010