3
16
16

1111111111111111
1111111111111111
1111111111111111
1111111111111111
1111111111111111
1111111111111111
1111111111111111
1111111111111111
1111111111111111
1111111111111111
1111111111111111
1111111111111111
1111111111111111
1111111111111111
1111111111111111
1111111111111111

0000000040004222
0444444040424540
0000002240404440
4444424040400000
0000024042444444
0444424040020000
0400024044424440
0404004000000000
0004004444444444
4444000000400000
0004444440404440
0000402040404040
2442404040404040
0040404040004000
0040404042444022
0040004000000020

0009000009000000
0000000000000009
0000090000000000
0000000000090000
9000000000000000
0000000000000000
0090000000000000
0000000000090000
0000000000000000
0000000009000000
0090000000000000
0000000000000900
0000000000000000
0000000000000000
0000000000000000
8009000900000000
